0000000000000000000000000000000000000000000000000000000000000000000000000000000000000000000000000000
0000000000000000000000000000000000000000000000000000000000000000000000000000000000000000000000000000
0000000000000000000000000000000000000000000000000000000000000000000000000000000000000000000000000000
0000000000000000000000000000000000000000000000000000000000000000000000000000000000000000000000000000
0000000000000000000000000000000000000000000000000000000000000000000000000000000000000000000000000000
0000111111111111111111111111111111111111111111111111111111111111111111100000000000000000000000000000
0000111111111111111111111111111111111111111111111111111111111111111111101111111111111111111111100000
0000111111111111111111111111111111111111111111111111111111111111111111101111111000111011111111100000
0000111111111111111111111111111111111111111111111111111111111111111111101111111111111111111111100000
0000111111111000111101111111111111111111111111111111111111111111111111100111111111111111111110100000
0000111111111111111111111111111111111111111111111111111111111111111111101111111111111111111111100000
0000111110111111111111111111111111111111111111111111111111111111111111101111111101111001111111100000
0000111111111111111111111111111111111111101111111011111111111111111111101111111111111111111111100000
0000111111111111111111111111101111101111111111111111111111111111111111101111111111111111111111100000
0000111111111111111111011111111111111111111111111111111111111111011111101111111111111111111111100000
0000111111111111111111111100111111111111111111111111111111111111111111101111111001111001111111100000
0000111111111111111111111111111111111111111111111111111111111111111111101111111111111111111111100000
0000111101111111111111111111111111111111111111111111111111111111111111101111111111111111111111100000
0000111111111110111111111111111111111111101111111111111111111111111111101111111111111111111111100000
0000111111111111111111111111111111111111111111101111111111111111111111101111111101111011111111100000
0000111111111111111111011111111111101111111111111111111111110111111111101001111111111111111001100000
0000111111111111111111111111111111111111111111111111111111111111111111101111111111111111111111100000
0000111111111111111111111111110111111111111111111111111111111111111111100000000001111000000000000000
0000111111111111111111111111111111111111111111111111111111111111111111100000000001111000000000000000
0000111111111111111111111111111111111111111111111111111111111111111111111111111111111111111111110000
0000111110111111011111111111111111111111111111111111111111111111111111111111111111111111111111110000
0000111111111111111111111111111111111111111111111111111111111111110111111111111111111111111111110000
0000111111111111111111111111111111111111111111111111111111111111111111111111111111111111111111110000
0000111111111111111111111110111111111101111111111111111111111111111111111111111111111111111111110000
0000111111111111111111111111111111111111111111101111111111111111111111111111111111111111111111110000
0000111111111111111111111111111111111111111111111111111111111111111111111111111111111111111111110000
0000111111111111011111111111111111111111111111111111111111111111111111111111111111111111111111110000
0000111111011111111111111111111111111111111111111111111111110111111101111111111111111111111111110000
0000111111111111111111111111111111111111111111111111111111111111111111111111111111111111111111110000
0000111111111111111111101111111111111111111111111111111101111111111111111111111111111111111111110000
0000111111111111111111111111111111111111111111111111111111111111111111111111111111111111111111110000
0000111111111111111111111111111111111111111111111111111111111111111111111111111111111111111111110000
0000111101111111111111111111111101111111111111111111111111111111111111111111111111111111111111110000
0000111111111111111111111111111111111111111111111111111111111111111111111111111110111111111111110000
0000111111111111111111111111111111111111111111111111111111111111111111101111111111111111111111110000
0000111111111111111111111111111111111111111111111111111111111111111111111111111111111111111111110000
0000111111111111111111111111111111111111101111111111111111011111111111111111111111111111101111110000
0000111111111111101111111111111111111111111111111111111111111111111111111111111111111111111111110000
0000111111111111111111111111111111111111111111111111111111111111111111111111111111111111111111110000
0000111111111111111111110111111111011111111111111111111111111111111111111111111111111111111111110000
0000111111111111111111111111111111111111111111111111111111111111111011111111110111110111111111110000
0000111111111111111111111111111111111111111111111111111111111111111111111111111111111111111111110000
0000111111111111111111111111111111111111111111111111111111111111111111111111111111111111111111110000
0000111111111111111111111111111111111111111111111111111111111111111111111111111111111111111111110000
0000111111011111111111111111111111111111111111111111111111111111111111111111011111111111111111110000
0000111111111111111111111111111111111111111111111111111111111111111111111111111111111111111111110000
0000111111111111111111111111111111111111111111111111111111111111111111111111111111111111101111110000
0000111111111111111111111111111111111111111111111111111111111111111011111111111111111111111111110000
0000111111111111111111111111111111111111111111111111111111111111111111111111111111111111111111110000
0000111111111111111111111111111111111111111111111111111111111111111111111111111111111111111111110000
0000111111111111111111111111111000000111111111111111111111111111111111111111111111111111111111110000
0000111111111111111111111111111111111111111111111111111111111111111111111111111111111101111111110000
0000111111111111111111111111111111111111111111111111111111111111111111111111111101111111111111110000
0000111111111111111111111111111111111111101111111111111111011111111111110111111111111111111111110000
0000111111111111111111111111111111111111111111111111111111111111111111111111111111111111111111110000
0000111111111111111111111111111111111111111111111111111111111111111111111111111111111111111111110000
0000111111111111111110111111111111111111111111111111111111111111111111111111111111111111111111110000
0000111111111101111111111111111111111111111111111111111111111111111111111111111111111111111111110000
0000111111111111111111111111111111111111111111111111111011111111111111011111111111111111111111110000
0000111111111111111111111111111111111111111111111110111111111111111111111111111111111111111111110000
0000111111111111111111111111111111111111111111111111111111111111111111111111111111011111011111110000
0000111101111111111111111111111111111111111111111111111111111111110111111111111111111111111110110000
0000111111111111111111111111111111111111111111111111111111111111110111111111111111111111111111110000
0000111111111111111110111111111111111111111111111111111111111111111111111111111111111110111111110000
0000111111111111110111111111111111111011111111111111111111111111111111110011111001111111111111110000
0000111111111111111111111111111111111011111111111111111111111111111111111111111111111111111111110000
0000111111111111111111111111111111111111111111111111111111111111111111111111111111111111111111110000
0000111111111111111111111111111111111111111111111111111111111111111111111111111111111111111111110000
0000111111111111111111111111111111111111111111111111111111111111111111111111111111111111111111110000
0000111111111101111111111111111111111111111111111111111111111111111111111111111111111111111111110000
0000111111111111111111111111111111111111111111111111111111111111111111111111111111111111111111110000
0000111111111111111111111111111110111111111111111111111111111111111111111111111111111111111111110000
0000111111111111111111011111111111111111111111111111111111111111111111111111111111111111111111110000
0000111111111111111111111111111111111101111111111111111111111110111111111111110111111111111111110000
0000111111111111111111111111111111111111111111111111111111111111111111111111110111111111101111110000
0000111111111111111111111111111111111111111111111111111111111111111100111111111111111111111111110000
0000111111111111111111111111111101111111111111111111111011111111111111111111111111111111111111110000
0000111111111111111111111111111111111111111111111111111111111111111111111111111111110111111111110000
0000111111111111110111111111111111111111111111111111111111011111111111111111111111111111111111110000
0000111111111111111111111111111111011111111111111111111111111111111111111111111111111111011111110000
0000111111111111111111111111111111111111111111111111111111111111111111111111111111111111011111110000
0000111111111111111111111111111111111111111111111111111111111111111111111111111111111111111111110000
0000111111111111111111111111111111111111111111111111111111111111101111111111111111111111111111110000
0000111111101111111111111111111111111111111111111111111111111111111111111111111111111111111111110000
0000111111111111111111111111111111111111111111111111111111111111111111111111111111111111111111110000
0000111111111111111111111111111111111111111111111111111111111111111111111011111111111111111111110000
0000111111111111111111111011111111111101111111100001111111111111111111111111111111111111111111110000
0000111111111111111111111111111111111111111111111111111111111111111111111111111111111011111111110000
0000111111111111111111111111111111111111111111111111111111111111111111111111111001111111111111110000
0000111111111111111111111111111111111111111111111111111111111111111111111111111111111111111111110000
0000111111111111111111111111111111111111111111111111111111111111111111111111111111111111111111110000
0000000000000000000000000000000000000000000000000000000000000000000000000000000000000000000000000000
0000000000000000000000000000000000000000000000000000000000000000000000000000000000000000000000000000
0000000000000000000000000000000000000000000000000000000000000000000000000000000000000000000000000000
0000000000000000000000000000000000000000000000000000000000000000000000000000000000000000000000000000
