###########.......B.....EEEE
..X.......#X............EEEE
..........#.............EEEE
..........#.............EEEE
.........X#.........X....#..
..........################..