#######################################:
##................##.................##:
##...#####........##.........#####...##:
##...#...#...................#...#...##:
##...#...#.................. #...#...##:
##...#####....##......##.....#####...##:
##............##......##.............##:
##............##......##.............##:
##.......#######......#######........##:
##...................................##:
##................##.................##:
#########.......######.......##########:
##................##.................##:
##...................................##:
##.......#######......#######........##:
###...........##......##.............##:
##............##......##.............##:
##...#####....##......##.....#####...##:
##...#...#...................#...#...##:
##...#...#...................#...#...##:
##...#####........##.........#####...##:
##................##.................##:
#######################################: